NO ./path_to_the_north_texture
SO ./path_to_the_south_texture
WE ./path_to_the_west_texture
EA ./path_to_the_east_texture

F 220,100,0
C 225,30,0

        1111 1111111111111111111111
        100111001100000000000011
        1011000001110000000000001111
        1001000000000000N000000000001
111111111011000001110000000000001111
10000000011000001110111111111111
11110111111111011100000010001
11110111111111011101010010001
10010000110101011100000010001
1000000000000001100000100001
1000000000000001101010010001
110000011010101111101111000111
11110111 1110101 101111011001
11111111 1111111 111111111111