1111111111111111111111111111111
10000000000C00000000C0000000001
100P010001000100010101000101001
1111100001000111000011100011001
100000C000000011100010000000011
1000000000000000000000C00000001
1000000000000000000000000000001
1000000C0000000C000000000000001
1000000000000000000000000000001
1000000100000010000011010011111
1111100001000111000011100011001
100000100E0000100000000C0000C01
1000000000000000000000C00000001
1000000C00000000000000000000001
1111111111111111111111111111111