1111111
1E00E01
1C000C1
1PE0001
10C00C1
1111111